{
    "spritesheet": "Game/tiles/desert.png",
    "width": 10,
    "height": 6,
    "layers": [
        {
            "z-index": 0,
            "index-map": [
                [1,2,1,1,1,1,1,1,1,1],
                [1,1,2,1,1,1,1,1,1,1],
                [1,1,1,2,1,1,1,1,1,1],
                [1,1,1,1,2,1,1,1,1,1],
                [1,1,1,1,1,2,1,1,1,1],
                [1,1,1,1,1,1,2,1,1,1]
            ]
        }
    ]
}