{
    "spritesheet": "Game/tiles/desert.png",
    "width": 10,
    "height": 6,
    "layers": [
        {
            "z-index": 0,
            "index-map": [
                [64,64,64,64,64,64,65,64,64,64],
                [64,65,64,64,64,64,64,64,64,64],
                [64,64,64,64,100,116,64,64,64,64],
                [64,64,64,64,101,117,64,64,64,64],
                [64,64,64,64,64,64,64,2,18,64],
                [64,64,64,64,64,64,64,3,19,64]
            ]
        }
    ]
}